Kring: Hommeltjes
Aafke De Raet - QXTL
Abby Van Bree - HKHY
Aimee De Raet - YPRQ
Alexa De Knegt - OZCZ
Alexianne Uitervinke - CIGH
Alma De Raet - TRTV
Amelia Ondermaets - TGZP
Amke Uitervinke - ISAG
Anabelle De Vis - EFJD
Anita De Knegt - ZZLK
Anita De Roeck - ZIQO
Annabel Onderstijns - IGIA
Annie De Knegt - MQYY
Annika De Boeck - ZBTD
Anoek Overhegs - CFXF
Babette Onderstijns - XQPA
Beatrix Van Larie - CGKW
Brenda Steurs - FLXC
Cassy De Steur - GUOC
Cecile De Raet - AJQT
Charlotte Ondermaets - FOZI
Dafne Van Swinkel - HKBF
Danielle Oversteyns - WFMU
Dea Steurs - RUFW
Debora De Bont - LTMZ
Debora De Vis - KHTR
Eefje Ondermaets - LFGV
Eefje Overhegs - PIYX
Elea Uitervinke - DVVC
Estelle Van Swinkel - MOJU
Esther Ondermaets - JDYO
Evie Onderstijns - TSZO
Famke De Vis - DZYG
Frida De Roeck - AKDG
Ghislaine Overhegs - FTWQ
Giselle Onderstijns - OTET
Giselle Oversteyns - YAVM
Greet Van Larie - UJID
Greta De vrij - YIOT
Griet De Knegt - ONBN
Gwendoline Van Bree - MUZQ
Hannelore Ondermaets - KJDZ
Inge De Boeck - YIZB
Inge Van Bree - SLUH
Jona IndePoort - HBSR
Karen De vrij - DRSB
Karolien De Roeck - OIDK
Katja Oversteyns - YDJZ
Kelly De vrij - GUJP
Kim De Boeck - GPAH
Kimberley Van Reemortel - HGAL
Kimberley Van Swinkel - LSND
Kitty Overhegs - WTIH
Kristel De Steur - RMQQ
Kristien De Bont - NRIL
Lea De Boeck - THLW
Leonor Van Reemortel - VGMF
Linda Onderstijns - FSQK
Madelief De Knegt - HMLY
Marijke IndePoort - PIGY
Marjolein De Vis - XJYA
Merel Uitervinke - JVAI
Mindy De Vis - AKDM
Mirjam De vrij - EWTK
Nadine Van Swinkel - HMMZ
Natalia IndePoort - HUDG
Rachelle De Knegt - GJLS
Ramona Van Bree - VBVC
Rita IndePoort - OPMR
Saartje Evas - CIIS
Sabrine De Raet - VNBO
Sarah Overhegs - UTRI
